##########
##########
##########
########@#
######...%
#####@.###
####...###
#@##.@####
!....#####
##########