###%#######
###.##@####
###......##
###@###@.##
##.....#.##
##.#@#...##
##.####@###
##.....####
####@#.####
######....!
###########